
NO ./textures/West_Wall.xpm
WE ./textures/North_Wall.xpm
EA ./textures/East_Wall.xpm
SO ./textures/South_Wall.xpm

F 255,12455,0
C 0,-111,255

1111111
1N00001
1000001
1000001
1000001
1000001
1000001
1000001
1000001
1111111