111111111
100100011
101000011
1100N1001
111111111