
NO ./textures/West_Wall.xpm
WE ./textures/North_Wall.xpm
EA ./textures/East_Wall.xpm
SO ./textures/South_Wall.xpm

C ,,
F ,,

1111111
1S00001
1000001
1000001
1000001
1000001
1000001
1000001
1000001
1111111
