11 11111
10 0101
101 001
11 00N1
111111 