1111111
1000001
1000001
1000001
1000001
1000001
1000001
1000001
10000W1
1111111