1111111111
10 0101  111001
101 0019000111
11 00N1001100000 
111111 111111