
NO ./textures/West_Wall.xpm
WE ./textures/North_Wall.xpm
EA ./textures/East_Wall.xpm
SO ./textures/South_Wall.xpm

F 255,0,255
C 0,255,255

1111111
1000001
1000001
1000001
1000001
1000001
1000001
1000001
10000W1
1111111